31 Temmuz 2011 Pazar













Sevgili okurlarým, gün geçmiyor ki Türkiye’de bomba gibi bir haber patlamasýn...





Þimdi de ordudaki deðiþim gündemde!





Bu arada, Cüneyt Ülsever’in deyimiyle “anormalleþen” “normal” yaþam da devam ediyor.





Bu sözde “normal” yaþamýn gerçeklerinden biri de suçlanan kiþilerin önce hapse atýlmasý, sonra yargýlanmasý.





Zaten son olay da tutuklu subaylarýn durumlarýndan dolayý çýkmadý mý!





Silivri’ye yollanan o kadar çok gazeteci var ki, bu kadar insanla birçok gazete çýkarýlabilir.





Basýnda sansürün kaldýrýlmasýnýn 103’üncü yýlý dolayýsýyla, hapisteki gazeteciler, 24 Temmuz 2011’de Türkiye Gazeteciler Sendikasý’nýn öncülüðünde bir gazete çýkardý; Türkiye’nin dört bir tarafýndan cezaevlerindeki gazetecilerin yazdýðý gazetenin adý Tutuklu Gazete.





***





Bu gazetede neler olduðunu aktarmak istiyorum.





Göbekten verilen manþet haber:





“SANSÜRE DÝRENÝÞ”





TGS Genel Baþkaný Ercan Sadýk Ýpekçi’nin yazýsý: “Gazetecilik faaliyetiyle direniyorlar.”





Bedri Adanýr: “Uçurtmayý vurmasýnlar.”





Nedim Þener: “Ergenekon Ergenekon diyordunuz, bakýn þimdi siz de Silivri’desiniz.”





Müyesser Yýldýz: Sendikasýzlaþtýrýlmýþ basýn tutukludur.





Vedat Kurþun: Kürt gazeteci olmak.





Ahmet Þýk: Bu yazý canýnýzý sýkabilir.





Barýþ Pehlivan: “Kendimle röportaj yaptým.”





Tuncay Özkan: AKP sonrasý Türkiye’de muhalif gazeteci olmak.





Soner Yalçýn: Tanýk mýyým, sanýk mýyým?





Füsun Erdoðan: Neden hapisteyiz?!





Barýþ Terkoðlu: “Gazeteciler hangi faaliyetlerinden dolayý tutuklu.”





Suzan Zengin: TMY ve özel yetkili mahkemelerin kaldýrýlmasý talebini daha yüksek sesle dillendirelim!





Sedat Þenoðlu: Gazeteci deðilmiþiz!





Deniz Yýldýrým: Basýn kime “özgür”?





A. Hicri Ýzgören (Konuk yazar): Yasakçý zihniyet.





Musa Kurt: Hâlâ mahkemeye çýkarýlmadým.





Barýþ Açýkel: 145 gazeteci cezaevinde.





Ali Buluþ: Basýn özgürlüðünü savunmak.





Miktat Algül: “Türkiye kuþatýlmýþtýr.”





Mustafa Gök: “2004 Þubat’ýnda tutuklandým.”





Seyithan Akyüz: “Ýddialar gerçeði deðiþtirmez.”





Faysal Tunç: Fikir iþçisi mi, fikir komandosu mu?





Rohat Emekçi: “Cezaevinde olma gerekçem trajikomik.”





Kaan Ünsal: “Sevgilerimi gönderiyorum.”





Fazýl Duygun: 5 aydýr fazladan yatýyorum.





Bayram Namaz: Tezgâhtaki balýk.





Mehmet Yeþiltepe: AKP’den neden demokratikleþme beklenmemelidir?





Hatice Duman: “Neden hapishanedeyiz?”





Halit Güdenoðlu: “Neyle suçlandýðýmýzý bilmiyoruz.”





Cihan Gün: Hücrelerden bir yazý.





Ozan Kýlýnç: Mazlum daha 16’sýnda iþkenceyle tanýþtý.





Murat Ýlhan: Negarî.





O. Baha Okar: Cezanýn karanlýk yüzü: Delile dayanmayan kanaatkâr iddianameler.





Sait Çakýr: Türkiye: Açýk hava cezaevi.





Mehmet Karabaþ: “Düþünce Özgürlüðü Yasasý TMK ile deðiþti.”.





Kadri Kaya: Medya ülkenin, toplumun gözü ve kulaðý iþlevindedir.





Sinan Aygül: Sizden korkan sizin gibi olsun.





Erol Zavar: Merhaba dostlar.





Hamdiye Çiftçi: Biz cezaevindeyken basýn sansürü özgürlüðü 103. yýlýnda.





Ahmet Birsin: Hegemonik olmayacaðýnýn turnusolu demokratik anayasadýr.





Kenan Karavil: Düþüncenin ruhu vardýr.





***





Yazýlar çok ilginç.





TGS, tarihe mal olacak bir gazete çýkarmýþ!











